CEO - Arbitranet	Business
Managing Director for Urban Us	Other
President - Northeast Area	Other
CEE Council Member	Business
VP Mobile, Data & Engagement	Business
Linguistic developer @ Parser team	Technical
Vice President, Data & Business Development	Business
IoT professional, EMEA Global Black Belt Team, Western Europe	Technical
Founder & Senior Manager	Business
Developer, Designer, Field Analyst at Open Technology Institute, NAF	Technical
Founder -CTO	Business
Global Head of Creator Development & Management	Business
University Dean for Educational Initiatives and CEO of EdPlus at ASU	Other
Constituent Services	Other
Head of Factual Development	Technical
CEO & ounder	Business
Cofounder/Advisor	Business
President - California and Nevada Region	Other
Chief Executive Officer / Executive Director	Business
Senior Vice President, General Counsel, Allegiance Telecom Company Worldwide	Business
Marketing and business	Business
Net & Windows Azure Team Lead	Other
World-wide Program Executive	Other
Managing Director Italy	Other
VP of Technical Marketing	Marketing
Search Editor	Other
Sales & Account manager	Sales
Development and Infrastructure Lead	Technical
School of Business - Advisor	Business
Head of Innovation Mapping	Technical
SVP, Healthcare	Business
Engagement Team Manager	Other
Principal at Atmosphere Research	Other
SR VP Media & Public Relations	Business
Grants Staff Member	Other
Social Outreach Manager	Other
RE200 Mentor	Other
MD and Head of US Capital Markets	Business
Controller and Vice President	Business
Chairman of the Board of Directors - Saint-Gobain Rakennustuotteet Oy	Business
Staff UX Researcher and UX Manager (Seattle/Kirkland)	Other
Inhouse Consultant - Leader Business Support of IoF2020	Other
CEO + Partner	Business
President and Head of Business Development	Business
Vice President (New Ventures)	Business
Director of Change Management	Other
enior Portfolio Manager, Senior Analyst and Vice President	Technical
Reg. Rep II	Other
Senior Manager, Internet Strategy and Services	Other
Co- Founder, Director of Customer Success	Business
Director, Digital, Growth, GTM Ops	Business
Director of Transaction Services	Business
Assistant General Manager & Chief Administrative Officer	Other
Sales / Marketing (BZ Results)	Sales
Art Historian, Translator	Other
Deputy Director, Bureau of Consumer Protection	Other
Shoutlet Product Marketing Manager	Marketing
Show Director	Other
Director | Owner	Business
Senior Director for Business Development & Compliance	Business
Online marketing	Marketing
Vice President, Mergers and Acquisitions	Business
Consulting Engineers	Technical
Vice President, Growth Ventures & Innovation	Technical
Professor of Clinical Medicine	Other
EVP & Deputy Publisher	Business
Vice President of Worldwide Operations and Quality	Business
Director of Management Control Center	Business
Executive Teams	Other
Senior Services Director	Business
GM, Global Field and Partner Marketing	Marketing
Sr. Manager, Creative Services	Other
EVP/Managing Director	Business
In-House Corporate Communication	Other
Lab VP, VP of Product Integration (Application Lifecycle Solutions)	Business
Chief Strategy & Innovations Officer	Business
Vice-President International Group	Business
Sales Director Europe - Smart City Solutions	Sales
Head of Publisher Development	Business
Author and Host	Technical
National Managing Partner, Markets and Talent	Business
Digital IC Designer	Technical
President of Caggiati	Business
Product & User Experience Director	Technical
Head of PSA Peugeot Citroen Innovation Cell @Singapore	Technical
Head Android	Business
Chief Legal Officer, Senior Vice President	Business
Research and Consulting Positions	Technical
Senior Manager of Business Analysts	Business
Apple Solutions Consultant	Other
Director of Cardiac Catheterization and Interventional Cardiology Laboratories	Business
Medical Educator and a Professor of Pharmacology	Other
Sr. Technical Acquisition Consultant	Technical
SVP, Interactive Marketing - America Online	Marketing
Engineer, Constellation Program	Technical
Head, APAC Emerging Markets	Business
Research Scientist & Head of Quantitative and Computational Finance Lab	Technical
President & Board Chairman	Business
Chief Financial Officer and Senior VP	Business
Consultant in Obstetrics & Gynaecology	Other
Radiation Oncology Resident	Other
Senior Architect, Cloud Foundry	Technical
Principal with Park Venture Advisors	Other
Bellevue/Eastside Chapter President	Business
Interim Marketing Executive	Marketing
People Operations Coordinator	Other
VP Platform & Growth	Technical
Founder/EVP	Business
Director, Strategy & Mergers and Acquisitions	Business
Variety of Management Roles	Other
General Counsel North America and Managing Director	Other
Venture partner	Other
SVP Technology, Key Markets	Business
Vice President of Customer Care	Business
Founder and Operations and Systems Manager	Technical
Senior Vice President, Energy and Aerospace Events	Business
Design Lead & Internal Customer Communications	Technical
Android Mobile Developer	Technical
President, Global Marketing and Category Development	Marketing
VP, Engineering & Technical Support	Technical
Designer/Usability	Technical
Private Equity Analyst Intern	Technical
AVP & Partner Strategy and Programs	Other
VP Dealer Services	Business
Senior Vice-President and Chief Financial Officer	Business
HR and Facilitites Manager	Other
Board of Directors; Dean, David Eccles School of Business	Business
Senior Vice President of Clinical Development & Chief Medical Officer	Business
Chief Excitement Officer	Business
Expert in Residence	Other
Executive Vice President, Business Affairs and General Counsel	Business
Director, Head of International Markets and B2B Development	Business
Co-Founder | CMO	Business
Co-Founder / Embedded Systems Architect	Business
Publisher and Chief Executive Officer	Business
Software Engineer, Tech lead	Technical
Director, Engineer US	Technical
Assistant Vice President, West Africa	Other
Jay Sunde Chapel Hill | Corporate finance in the real estate	Other
President of Goldman Sachs Japan	Business
Vice President, Global Operations, Automation and Controls Solutions	Business
Gavin Potts	Other
Vice President of News & Marketing	Marketing
Director, Airspace Research	Business
VP & Head of HR	Business
Senior Vice President, Worldwide Sales and Field Operations	Sales
Business Development Manager, New Business Group	Business
Principal / Chief Revenue Officer	Other
Chief of Staff and General Counsel	Technical
VP Content Acquisition and Business Development	Business
Solutions Architect & Process Analyst	Technical
Founder/Exec Producer/Digital Publisher, EMAP Consumer Online	Business
Market Risk	Other
Manager of Vision Sensing Lab	Other
Vice President - Technical Recruiter	Technical
SVP, Merchandising Services - Houston HQ	Business
Chairperson and General Partner	Other
Design Engineer - PentiumÂ® Processor	Technical
Sr. Director - Supply Chain	Business
Venture Hacker	Other
Corporate Compliance Officer	Business
Future Angel	Business
Web Designer / Illustrator	Technical
Global Vice President and Sr. Staff - Industry 4.0	Business
Senior Vice President of Enterprise & Channel Sales	Sales
Customer Success Team Lead	Other
Marketing and Communications Head	Marketing
Vice President and General Manager APJ	Business
Partner, Executive VP R&D and Commercial	Business
Co-founder, Customers	Business
Head brewer	Business
Assistant Vice President of Enrollment Marketing & Communications	Marketing
SVP Chief Compliance & Integrity Officer	Business
Software Engineer at IBM Nederland B.V.	Technical
Sr. Business Development Manager EMEA Online Gaming	Business
various technology leadership	Business
directs the California Reading and Literature Project	Technical
Head of Market Intelligence	Marketing
Board Adviser	Business
CTO/Chief Programmer	Technical
Key Account Manager/Project Manager	Other
SVP and General Manager of Rewards Based Games	Other
Co-founder, Project Manager	Business
Manager, ProVation Order Sets & Clin-eguide Field Sales Teams	Sales
Investment Team Partner	Sales
Exec Vice President, Corporate Secretary & Director	Business
Executive Vice President of Worldwide Sales & Marketing	Sales
Senior Engineer, Staff Engineer, Senior Staff Engineer	Technical
Director, Finance & Information Technology - UK	Other
Chief Academic Liaison	Technical
Business Model Innovation Extern	Business
CTO & Co-Owner	Business
Ukash	Other
Senior Director of Preclinical Safety	Business
Director, TNS UK	Business
Sr. Director, Marketing and Creative Strategy	Marketing
Founder, CEO & Brand Ambassador	Business
Developing Highly Scalable Software Solutions	Other
General Board Member	Business
Deputy Program Manager for the International Space Station	Other
brand consultant	Other
Online Marketing Representative	Marketing
Senior Director - Head of Product	Business
Deputy Chairman & Founding Partner	Business
Senior Vice President of Financial Institution	Business
VP Global Blockchain Labs Engagement	Business
Similar Global Management	Business
Advisor - Technology Commercialization	Other
Judicial Law Clerk	Other
Vice President Industry Outreach	Business
Member of the Director Commitee	Business
Showbiz/Entertainment Editor	Other
Director of Comercial	Business
Course Director	Business
Vice President of APAC	Business
Futurologist	Other
Administrative, Financial Analyst	Technical
President & Chief Business Officer	Business
Staff Engineer, IOT	Technical
VP, Enterprise Technology Svcs	Business
Board Member / VP Marketing	Business
Senior Director, Product Management and Global Go-to-Market Process	Business
Chief Data Officer Global HR	Business
Executive Vice President of Business & Board of Directors	Business
Senior Manager - Enterprise & SMB Retention Strategy	Other
VP - Goldman Sachs - Frankfurt / Associate - New York & San Francisco	Business
VP, Supply	Business
Lincoln Fellow	Other
Consulting Projects	Other
Mobile Business Development & Incubation	Business
Game Programmer	Technical
Executive Vice President, Group Human Resources Director	Business
Variety of Commercial Operating Roles	Other
Director, Medical Group	Business
Marketing & Sales representative	Sales
Founder & CEO @ NewsMaker	Business
Localiser for Greece	Other
Vice President and Co-Founder	Business
Partner, Software Applications Practice	Other
Vice-president for administration	Business
SVP / Chief Business Officer	Business
Consulting Director & Partner	Business
Lerner Research Institute	Technical
Director, Creative Strategy/Channel Head, PlayJam	Business
Vice President of Marketing & Innovation	Technical
Director, Scotland	Business
Senior Vice President, Activation Director	Business
SENIOR OFFICE ASSISTANCE	Other
Director of Aviation	Business
Director, Embedded Software	Technical
Post Production Director	Business
iOS Development	Technical
Executive Vice President â Head of Emerging Technologies	Business
Founding Member & Chief Sales Officer	Sales
CTO and Executive Vice President of Products	Business
Vice President of Biopharmaceutical Development	Business
Corporate Chef.	Other
Professional Daydreamer	Other
CEO & Producer	Business
Chief Administrative Officer & CFO	Business
SVP, Creative Solutions & Strategy	Other
Operations Manager & Founder	Business
Label and Publisher Relations	Business
General Manager of the First Projects Group Heavy Machinery Division	Other
Director Digital Human Group	Other
Executive Director, SelectUSA	Business
Business Development Consultant & Product Manager	Business
VP, PC Client Group & GM, Global Ecosystem Development	Business
CPO, CTO	Business
CAO	Other
Head of Technology Middle East and Africa	Business
Co-Founder and Venture Partner	Business
Vice President, Global IT Service Operations	Business
Member / Advisor	Other
Vice President, Advanced Packaging Business Unit	Business
Vice President of Research Services	Business
IT and IS Manager	Technical
Corporate Partnerships Leader	Other
Public relations and social media executive	Business
Senior Director, Oncology	Other
Founder and Chief Scientific Advisor	Technical
Director of Business Development and Innovation	Technical
Senior Vice President & Executive Producer	Business
Investment Banker - M&A Group	Business
Global Sales Head	Sales
Director of Key Laboratory of Particle Astrophysics	Business
facilitator	Other
Sr Director, Advanced Strategies and Research	Technical
Vice President-Global Growth Accounts	Business
Non Executive Chairman and Director	Business
Hedge Fund Research	Other
Investment Banking & LabMorgan	Business
Vice President Sales, The Americas	Sales
Executive Vice President of Operations and Client Services	Business
FOUNDER, ENTERPRENEUR, TIME MANAGEMENT EXPERT	Business
Managing Director and COO	Other
SEG Director, Director & General Manager of Neusoft Japan	Business
Clara Llamas	Other
Does-It-All	Technical
Program Manager - Audiovisual & Videoconferencing - Enterprise Directorate	Other
Director of Media Affairs	Business
Chief of Research Stefaan Verhulst	Technical
Senior Prototyper - Global Product Development	Business
API Developer | Server Admin	Technical
V.P. Finance, Global Operations	Business
Senior Vice President, Talent Acquisition, Engagement & Development	Business
Risk & Compliance	Other
Director of UX	Business
VP & Regional Counsel	Business
Director, Sales Strategy & Operations, Americas	Sales
VP / GM - Feminine Protection Products-U.S. - Procter & Gamble North America	Business
Banking Intern	Business
CPO Head & Country President	Business
VP, Advertising - Americas	Business
Head of Community Engagement	Business
VP of Enterprise Marketing	Marketing
Senior Advisor to Director Richard Cordray	Other
Executive - Loan Origination	Other
Country Director, Colombia & India	Business
Director Of Procurement	Business
Strategic Security Advisor	Technical
KinTrans Board Member	Business
Chief Financial Officer (Interim CEO/President)	Business
Senior Beauty Editor, StyleList.com	Other
Purchasing Mgr	Other
Sr. Product and Software Developer	Technical
Chief General Counsel	Business
Agent, Digital & Brand Marketing	Marketing
Chairman / CTO / Founder	Business
Director of Lending	Business
VP, Dev	Business
Senior Homes Manager	Other
VP, Financial Planning & Internal Audit	Business
Presence Marketing Manager	Marketing
Co-Founder & 3D Designer	Business
Electronic Product Delivery Manager	Other
Managing Director Continental Europe and VP of Sales EMEA	Sales
Senior Vice President and Global Head & Drug Regulatory Affairs	Business
Vice-President and Evangelist	Business
Chief Customer Success	Other
Group Business Chief	Business
Secretary to RBIâs Central Board	Business
Senior Vice President & Chief Product Officer	Business
Business Development & Marketing Director	Business
Revenue Operations	Other
Vice President Sales, APAC	Sales
Brand and Category Manager	Other
UX manager	Other
Publisher / Editor, CEO	Business
Computer Scientist, Software Development	Technical
Managing Director, Cyber Security and CTO	Technical
Product Marketing Manager, OneDrive	Marketing
Head of Education Technology and Higher Education	Business
Research Scientist and Manager	Technical
Lead DBA / Technical Manager	Technical
CFO, Co-Founder & Co-Owner	Business
Vice President Human Resources and Organizational Development	Business
Chief Revenue Officer / Senior Vice President Sales & Field Operations	Sales
VP of Strategy & Communication	Business
CTO & Director of NextGen Products	Business
Head of Payment Products, Asia Pacific Region	Other
Operations Manager - Mexico City	Other
Sr. Manager, Sales (Global)	Sales
Brand & New Business Manager	Business
HR group vice president	Business
VP & GM - Boeing Research & Technology	Business
Administrative, Operational and Financial Positions	Business
senior web developer	Technical
VP Wireless Network Engineering	Technical
VP (R&D)	Business
Founder & Chief Scientist	Business
Sales Director (Thailand)	Sales
Head of Data Engineering - Product Foundation, Search, Profile	Technical
Senior Content Strategy Lead	Other
Director of Business Development (Intel Japan)	Business
Managing Director, Co-head Global Venture Investing	Other
Accounting Geek	Other
Group President of Digital	Business
Senior Director Experience Design	Technical
HR & Supervision	Other
PR & Comms	Other
Executive Director of HD Map and Localization	Business
Sr. Director Sales Strategy & Operations	Sales
Executive Chariman	Other
Senior Interface and Web Engineer	Technical
V. P. Finance	Other
Advisor, President & COO	Other
Director of Marketing Programs	Marketing
Sr.Lecturer	Other
Senior Development Manager	Technical
Vice- President of Corporate Development	Business
Senior Consultant - Corporate Performance - Restructuring	Other
Sperimentatore Musicale	Other
Chief of Research and Innovation	Technical
Sales Manager - Benelux	Sales
Vice President of Client Service	Business
Global Policy Chief	Other
SVP Global Sales and Business Development	Business
Director / CMO	Business
Studio Art Director	Business
Finance Operations Manager	Other
Founder & President Cloud Consulting	Business
Conversion Optimization Strategy Manager	Other
Director, VAR, Government & Strategic Accounts	Business
ABS Summer Trading Analyst	Technical
Senior Vice President Corporate Development, General Counsel & Secretary	Business
Co-Founder / SVP	Business
Leder Prosjekt og Marked, Technology	Business
Sr. Director - Products & Community	Business
Discovery engineer	Technical
Vice-President of Threat Research Unit	Business
Technology Zinger	Business
EVP â Business Development & Product	Business
Vice President of Air Traffic Services & Navigation Database	Business
Sr. Research Director	Business
Manager, Business Development - Partnerships	Business
Executive Vice President of Human Services & Housing	Other
WebObjects Developer	Technical
Senior Vice President & Associate Chief Operating Officer	Business
Professor (honorary)	Other
Art-director	Business
Director of Automated Recognition Business	Business
Head of CEU EMPRENDE	Business
EVP of Finance and Co-Founder	Business
Manager of IT for National Accounts	Other
Co-Founder and former Editor-in-Chief	Business
Reporter and copy editor	Other
Co-Founder & VP of Strategy	Business
Marketing Communications Coordinator / Program Manager	Marketing
Manager, HSE	Other
Chairman, IAMAN Board of Advisors	Business
Manager, Operational Strategy	Other
Client Development	Business
Ownership Advisory Group Member	Other
VP, Head of Global Account Management, PCH	Business
Director of the Digital Engagement Team	Business
SVP Sales of North America & APAC	Sales
Principal Engineer - Autonomous Driving Planning and Control Lead	Technical
Project Manager, PHP programmer	Technical
Acting/Interim, Marketing Officer	Marketing
Consultant - Procuri Project	Other
President, Worldwide Operations	Business
Operating Partner / Industry Advisor	Other
Vice President, Product Solutions	Business
Vice President of Strategic Commerce Consulting	Business
VP content business development	Business
Head of Middle East and Africa	Technical
Vice President and Chief Architect, Cyber Security	Technical
Head of Security Lab	Technical
Ex-President (America)-TATA Consulting Services, Ex- CEO-Birlasoft; Ex-President, COO & Board Member	Business
Founder&CEO	Business
Engineering Team Lead	Technical
International Steering Group member	Other
Director of Video Engineering	Technical
Director General/ CEO	Business
Co-founder & Head Of Operations	Business
Head - Bauxite Exploration / Head - Mergers & Acquisitions / Plant Manager - Ãrdal, Norway	Business
VP, Inflight Experience	Business
Managing Director - Palo Alto	Other
Co-Owner, Operations Manager	Other
Vice President, Clinical Affairs	Business
Participating Principal	Other
Computer Science âÂ TA, Section Leader	Other
Senior Mobile Apps Engineer	Technical
Website & Social Strategy	Other
Founder / Chief Creative and Product	Business
Vp & CFO	Business
Head of Newsroom Development	Technical
SEAL Officer	Business
Director of Technology for the Web Hosting Company	Business
SVP, Global Solutions Development	Business
Coordinator, Music & Media Licensing	Business
Head - HR Strategic Initiatives & Leadership Development	Business
VP - Dow Jones Newswires	Business
Enterprise Sales Consultant in Retail Vertical	Sales
Vice President Corporate Strategy	Business
Head of Corporate Finance (VP)	Business
Salesforce Project Manager	Other
Lead Sponsorship and Logistics	Technical
Electronics & Design Lead	Technical
Co-Founder, Head of R&D (VidyoCast)	Business
Vice President of Systems Sales & GM of Telecommunications in Asia Pacific	Sales
Owner and Photographer	Business
Scientific Founder & Board Director	Business
Managing Director, Business Innovation	Business
Regional or National IT service head	Technical
Team Member, Ontario	Other
Director - Media and Entertainment Solutions	Other
Investor & Senior Advisor	Other
Co-President and Founder	Business
OSJ Branch Manager	Other
CEO Singapore & Head of International	Business
Interim Chief Technology Officer	Business
Vice President of Worldwide Marketing and Sales	Sales
General Manager for Health Insurance	Other
Vice President & General Manager of the Wireless Communications Division	Business
Dir- Security Solutions and Strategy	Other
Vice President of New Business Development & Digital Strategies	Business
Corporate Strategy Consultant	Other
Associate Vice Provost for Enrollment & Undergraduate Admissions	Business
Oracle Functional Consultant - CRM	Other
Sales and Partnership Manager	Sales
Co-Anchors of CNBC Power Lunch	Other
OptaPro Client Support	Other
Investor/Boardmember	Business
Vice President, Clinical and Medical Affairs	Business
Minister of Daily Deals	Other
Consultant to the CEO	Business
Customer Service Officer	Other
Regional Vice-President	Business
Executive Chairman & CEO, Siemens Australia New Zealand	Business
Vice President Customer Delivery	Business
Creative Producer and Podcast Co-host	Business
Senior Clinical Resourcing Advisor (Nurse)	Other
College Counsellor, Global Summer Internship Program	Business
Co-Founder and Chief Coaching Officer	Business
Country Manager a.i.	Other
Director, North & Special Events (UK)	Business
SVP, Home Services	Business
Principle Advisor, IoT Transformation Advisory Practice	Other
Patient Engagement Specialist	Other
Group President, Digital Banking	Business
Group Business Transformation Director	Business
Co-Founder // Chief Product Officer	Business
Localisation and Internationalization Expert	Technical
Smart Internationalization, consultant	Other
Resources Director	Business
Social Media Strategist / UI Designer	Other
CIO & CTO	Other
Independent Director and Member of Compensation Committee	Business
Researcher, Microprocessor Research Lab	Other
Analyst - Equity Capital Markets	Technical
Commercial Advisor and Regional Economist	Other
MTS Software Engineer	Technical
Digital Consultant Senior Automotive	Other
Vice President - Canada	Business
Startup Hacker	Other
Country Manager Germany M2M	Other
Assistant Professor of Medicine	Other
Head Of Marketing - KWAI Indonesia	Marketing
General Manager, IBM Global Technolgy Services New Zealand	Other
Senior Vice President of Research, and Member of Genentechâs Executive Committee	Business
Senior Content Engineer	Technical
Director, Chief Executive Officer & President	Business
Director of Corporate Management	Business
Money Market & Foreign Exchange Analyst	Technical
Lead Application Developer/Design Architect (Consultant)	Technical
Power Electronics Design Engineer	Technical
Vice President, US Surgical Business	Business
Founder, Visionary & CEO	Business
VP - Finance - Global Consumer Products Group & Latin America	Business
Senior Vice President of Business, Market and Partner Development	Business
Director Asset Management	Business
Co-founder, Client Lead	Business
Vice President Marketing, Enterprise	Marketing
Chief Web Developer	Technical
Assistant Deputy Chief of Staff G-3/4 for Integration and Synchronization	Other
Marketplace Manager - San Francisco / Pacific Northwest	Other
SVP & General Manager, Data Center Group	Business
Head of Games Studio Upopa	Business
Senior Product Specialist	Technical
Head - Sterile Product Formulation Development & Clinical Manufacturing	Other
SVP, Products & Solutions	Other
NICK TSAGARIS â A PERSON WHO WILL RESTORE YOUR FAITH IN HUMANITY	Other
Director, Product Architect	Business
Executive Vice President, Project Support Services	Business
Master's Student, Learning, Design, Technology	Technical
PresidentâIntermodal	Business
Executive Director of Experimental Therapeutics	Business
Partner and Co-Chair of U.S. M&A	Other
Industry Manager Defense, Intel and National Security	Technical
CMO/CPO	Other
Chief Financial Officer & Senior Vice President Corporate Services	Business
Sales, Marketing, Strategic Planning, & General Management	Sales
Founder,CEO,Partner	Business
Director of Human Resources, Corporate and Legal Affairs	Other
General Partner & Vice Chairman	Business
President of Ipsos Healthcare Japan Ltd	Business
SVP, Marketing Brand Partnerships	Marketing
Head of Finance, Treasury, and Operations	Other
Founder, SVP Product and Data Integrations	Business
Managing Partner, Consumer Products & Retail Practice Leader	Other
General Manager, Commercial Products	Other
Chief Software Architect, Digital Products	Technical
Product Owner SphereMall	Business
VP Product & Operations	Business
President - Sales, Presales and Delivery	Sales
Sr. Brand Manager - Netscape Internet Service	Other
Senior VP, Chief Mission Officer	Business
Investment Director & General Counsel	Business
Chief Product Officer & Founder	Business
Vice President, Strategic Relations	Business
Directorate for Education and Human Resources Programs	Other
Chairman of the Board of Directors, La Jolla Community Foundation	Business
GM, Microsoft Security Response Center (MSRC)	Technical
Founder, COO & VP Product	Business
Director of Sales, West	Sales
Service Provider Marketing	Marketing
VP, Product Development and Support	Business
Head of	Business
SVP Interactive	Business
Head of the Brand management & Spec. projects department	Business
Mobile Software Engineer, Co-Founder	Technical
Co-Founder & Executive Vice-President, Technology	Business
Analyst, Office of Budget, Management and Finance	Technical
Programme Director,Netherlands	Business
VP | Consumer Partnerships & Technology	Business
CFO & EVP	Business
Real Estate Broker & Realtor	Other
Architect & BIM Manager	Other
CEO, Social Venture Partners-Dallas	Other
President and Chief Revenue Officer	Other
Sr Director Analyst	Technical
Co Founder, VP BD & Sales	Sales
No longer with firm	Other
Partner & Regulatory & Strategy Lead	Other
Board Member/Partner	Business
SI/PI Consultant	Technical
Managing Director of Policy & Strategy	Other
Aperations	Other
Co-Founder & Director of Products	Business
Solutions Consultant, Strategic Accounts	Other
Director of The Usability Group	Business
CEO & Board Of Directors	Business
VP / Product Line Executive, Risk & Compliance Solutions	Other
wathura	Other
Senior Member, Technical Staff / MTS	Other
Research and Engineering	Technical
SVP, Global Agency Business Development	Business
Principal, CBDI	Other
VP, indiCo Store Services â Canada	Business
Co-Founder, Insurance Products & Revenue	Business
Key Leaders of the Enterprise Risk and Internal Audit Practices	Other
VP, AddictingGames	Business
Director of Operations & HR	Other
EVP & General Manager - HSN.com	Business
Deputy Chief Executive Officer, India	Other
Master Lecturer	Other
Cloud Foundry Staff Engineer	Technical
Head of Partnerships & Promotions	Business
Sr. QA Engineer	Technical
Communications Associate	Business
Managing Director, Head of International for IP and Technology Law	Business
Senior Partner, Executive Coach	Other
Sales Consulting and Solutions Teams	Sales
Senior Director of Data Services	Business
LOCAL HEAD OF EQUITY	Technical
Chief Physician	Technical
Doer of things	Other
Commercial Director & General Counsel	Business
Head of Mobile Business Development	Business
Member, Science Advisorary Board	Business
Content Uploads	Other
Founder, MARKETCLOUD	Business
Head of Business Unit & CTO	Business
Global Director of Entertainment + Branded Partnerships	Business
Music Programmer	Technical
UX/UI & Visual Designer	Technical
Director of Systems Development	Technical
President & CEO, Diagnostics Division; Head, Global Pharmaceuticals Research & Development	Business
Director of Government Affairs, Policy & Strategic Planning	Other
Head of planning division	Business
Engineering lead of Personalization	Technical
Senior Manager, Business Development	Business
Finance and HR	Other
Boardmember	Other
Senior Vice President, and Vice President of Food Business Division, Food Business	Business
VP of Technology & Logistics	Business
Chartered Accountants	Other
Director, Global Payments	Business
Vice President, Global Business Group	Business
Chief Marketing Officer + Co-Founder	Business
Commercial Editor	Other
Sr. Vice President / Public Relations	Business
Founder; President; CEO	Business
Founder & Chief Eternal Optimist	Business
Co-Founder, Executive Vice President of Engineering and Director	Business
Principal Research Staff Member	Other
Co-founder and Director or Sales and Marketing	Sales
Director, Analytics & Targeting Seattle	Business
Vice President Corporate Marketing	Marketing
Vice President/Head of Marketing/Associate Publisher	Business
Generalist	Other
Co-Founder at LetterMe	Business
Singapore Office Representative	Other
Co-Founder | Operations & Brand Relations	Business
IT Helpdesk Specialist	Technical
Managing Director - Commercial Lending	Other
IceNetwork Researcher	Other
Transaction Advisory Executive	Business
Head Of Engineering, Wallet	Technical
Works Council Chairman	Business
Senior Admin Executive	Other
Lead Global Robotics & Automation Engineer	Technical
Emergency Technician-Clinical Pathology	Technical
Professor and Chairman of the Department of Chemistry	Business
Owner & Chief Apple Officer	Business
Worldwide Program Director - Go-to-Market	Business
SVP Marketing & Advertising, VP, Advertising	Marketing
Global Director of Corporate Responsibility	Business
Co-Founder & CEO/COO	Business
Senior DevOps Specialist	Technical
Intake Coordinator	Other
Sr. Director, Global Infrastructure	Business
Enterprise Sales Executive- Southeast	Sales
National Political Reporter	Sales
Interim Manager, Business Operations	Business
Group President, Global Family Care	Business
Software Architect,,Principal Development Manager	Technical
Island Guide Manager	Other
Head of Devt	Business
Director Technology & Innovation Policy	Technical
Associate Data Engineer	Technical
Technology advisor	Other
Global Social Lead	Other
Executive Director, Health Care Programs - Heinz	Business
VP Global Video Sales	Sales
SciÂ­enÂ­tific AdviÂ­sory	Other
Vice-Rector	Business
Non-Executive Director & Investor	Business
Global Director, Global Technology Partners, Cloud Ecosystem & Business Development	Business
Accounting Technician	Technical
CFO, Romania & Moldova	Business
Director of BPO Services	Business
Marketing Manager (Oculex Pharmaceuticals)	Marketing
EVP, Chief Scientific & Strategy Officer	Technical
Regional Vice President of JGA	Business
Vice President ATG Network Solutions	Business
General Counsel, Director of Corporate Development	Business
Global Dental Sales Manager	Sales
Board Member, Executive Committee, Treasurer	Business
Non Executive Director (Board)	Business
Inventory Analysis	Other
Co-founder & Associate Executive Director	Business
VP Sales (Advisory)	Sales
Founder & CAO at TechNCR	Business
Vice-Dean (Research), Faculty of Engineering	Technical
Founder, CTO and Director	Business
C.T.O., Co-Founder	Business
Head Of Insurance	Business
Senior PHP programmer	Technical
Senior Vice President & General Manager - GameTime & Southern Fulfillment Center	Business
Corporate Business and Engineering Management Roles	Business
Director Infrastructure Services	Business
Head of Finance Business Partner	Business
SVP, Technical Advocate	Technical
Metropolitan Board	Business
Project manager, website design and code programming	Technical
Chief Medical & Quality Officer	Business
Head of Engineering, Real Time Communications	Technical
Digital Mech	Business
Executive Vice President, Business Affairs & General Counsel	Business
Head of Strategy and Development	Technical
Copy Lead	Technical
Principal Engineer and Director	Technical
Emerging Technology Guru	Business
Director of the Bone Marrow Transplant Program	Business
Vice President, Business Development & Strategic Accounts	Business
Comarch, Inc CEO	Business
Founder and Analyst, Official Account - China to Beijing.	Technical
VP of IP Consulting & Innovation	Technical
SVP & Head Systems Delivery	Technical
Associate Counsel, Licensing	Business
Chairman & co-founder	Business
Group chief executive officer, managing director, and director	Business
Market & Product Line Expansion	Marketing
Product Manager, Digital/Senior Mobile Engineer	Technical
Founder CEO & Chairman	Business
Senior Project Manager	Other
Portfolio Manger	Technical
Senior Reporter - Gadgets	Other
CEO, Co-Founder and Director, Space Trade and International Affairs	Business
Ideil	Other
Director Technical Sales & Customer Marketing (Roving Networks products)	Sales
Co-Founder; President	Business
COO/CTO, Founder	Business
Founder & Strategy	Business
Owner-Founder	Business
CEO Strategic Partner	Business
Senior Vice PresidentâCommercial	Business
Head of Product, Data & Marketing	Marketing
National Acquisition/Deployment Manager	Other
VP, Global Business Operations	Business
Director - IIB Council	Business
Head, Ad-ops Department & International Media Buying	Business
Vice President of Consulting services sales & Business Partners	Business
Co-Founder & Deputy CEO of Finance and Operations	Business
National Creative Director, India	Business
VP Engineering and Product	Technical
Executive Director of Innovation and Research	Technical
Tuition Tutors Worldwide	Business
Global Director, Sales	Sales
Co-Founder & VP Product	Business
Co-Founder and Head of Publisher	Business
Business Developement Associate	Business
Investment Banking Summer Associate - Technology, Media & Telecom	Business
Vice-President, Corporate Legal and Corporate Secretary	Business
VP, General Manager - DiskOnKey Division	Business
Senior Vice President, Business Infrastructure	Business
Co-Founder of Ennovate	Business
marketing roles	Marketing
Senior Director of Program Strategy in the Center for Applied Biodiversity Science	Other
Head of IT Application Services	Technical
Director. CPU Design	Business
District Director - Operations	Business
Senior Advisor to CEO	Business
Head of Americas Gas Research	Business
Director of Architecture and Innovation	Technical
Principal Cyber Engineer	Technical
Responsable technique	Other
VP, Clinical	Business
Head Creative Designer	Technical
Co-Head of EMEA Healthcare	Business
Budget Manager	Other
VP of Fiance	Business
Global Head of Bussiness Development	Business
Senior Director Sales Strategy and Client Services	Sales
Admissions Counselor	Other
Data Scientist and Solutions Architect	Technical
Outreach/Business Development	Business
Head of the Project Management Team	Technical
Senior Product Marketing and Strategy	Marketing
Senior UI/UX Designer, Front-end Developer	Technical
Senior Director of Modeling	Business
President - U.S. Human Health	Other
Co - Founder & Managing Member	Business
Product Manager (Europe)	Business
GM and Vice President of Engineering	Technical
The Write Imprint	Business
credit card Sales Executive	Sales
HeadÂ­ of Operations & Clients Services	Business
VP, Platform Partnerships	Business
Director - Inventory & Distribution	Business
Vice President, Finance, Chief Financial Officer, Secretary and Treasurer	Business
Senior Data Platform Engneer	Technical
Marketing and Revenue Director and Chief Revenue Officer	Marketing
CTO/CMO Partner	Other
Hosting Support	Other
Vice President & Head of Strategy and Business Development and Group Company Secretary	Business
Head of Sales EMEA & APAC	Sales
Head of ETRM & Trading Process Management	Business
Mobile learning expert & founder	Business
Director, Digital Marketing & Analytics	Marketing
Whole-time Director & Chief Financial Officer	Business
Advisor to the CEO and Board	Business
SVP, IT and Chief Information Officer	Technical
Head of Partners	Business
Managing Partner for Strategic Partnerships & Business Development	Business
Life Science Curator/Life Science Program Director	Business
Senior Software Engineer / Team Lead	Technical
Co-Founder & Executive Council Member	Business
Principal Scientist & Assistant Member	Other
Chief Executive Officer, Chairman, and Co-Founder	Business
WW Commission System Manager	Other
Portfolio Interin Chief Operrating Officer	Technical
VP and GM Payment and Kiosk	Business
Senior Vice President of Space Programs	Business
Co-Founder and Chief Creative Strategist	Business
Associate Director & Group Leader	Business
GM/VP New Business	Business
Co-Founder & R&D Director	Business
Senior Vice President of US Publisher Service	Business
President of Express Scripts Vision	Business
Law Editor	Other
Enterprise Health Neighborhood Lead	Technical
Member, Malliaras Group for Organic Optoelectronics	Other
Director of M&A and Corporate Strategy	Business
Advisor, Business Development	Business
Senior Investment Banking Positions	Business
Chief Financial Officer CFO	Business
Director, Business Head of Stanby	Business
Sr Director, Business Applications	Business
Founder , Marketing & Business Developer	Business
Managing Director/General Manager	Other
Vice President of Government Affairs & Consulting Services	Business
Principal, Tregaron Capital Company and Managing Director, GlowTouch	Other
Board Member & Past President	Business
Founder and SVP Engineering	Business
Intern, Life Sciences Group	Other
Marketing Manager, Advanced Products	Marketing
Managing Director, Client Relations	Other
Proprietor / Freelance Digital Designer	Technical
Assistant Director, Visionary Media Group	Other
Interim CEO-VersaPoint JV, SVP Business Development	Business
Co - Founder , President and Chief Executive Officer	Business
Staff Systems Engineer/Architect	Technical
Director, Mobile Programs	Business
Online & Mobile Media Sales Manager	Sales
President (Commercial), Diesel Systems	Technical
ADvisor	Other
Manager eID Solutions	Other
ITO Advisor International Markets	Business
Senior Director, Manufacturing Operations	Other
Consultant then Business Development Manager	Business
Chief Engineer, Founder	Technical
Vice President, Mobile Money Transfer Products and Deployment	Business
co-founder, prod/mktg/bizdev	Business
Alchemist, co-founder	Business
Creative Artist/Designer	Technical
Cofounder & EVP	Business
Management Committee	Other
Chief Energy Researcher	Business
Investor, Senior advisor and Board member, Leading Corporate strategy in Olyseum	Business
Manager - Finance & Operations	Other
SVP & CIO Corporate Functions	Sales
Senior Vice-President Brand Marketing	Marketing
Global Head of Innovation and Design	Technical
Mobile Technology Programme Director	Business
Vice President, Sales, Service & Marketing	Sales
Threat Intelligence Analyst, EMEA	Technical
Founder / President	Business
Head of UK Legal	Business
Directed the HR department	Other
Adjunct Faculty (Invited)	Other
Writer & Filmmaker	Other
Vice President, Head of Consumer & Marketing Analytics	Marketing
President â West Region, Complex Care Management	Other
Engineering, Sales and Sales Management	Sales
Advisor & Business Development Consultant	Business
President, Real Estate Investments	Business
Sr. Director, Systems	Technical
Business and Strategy Advisor	Business
VP Digital Product Development	Business
Senior Vice President, Aon Finanacial Services	Business
Director of Insight	Business
Marketing Executive - Engine Leasing Americas	Marketing
Director (Finance) & CFO	Business
BOD Asia	Other
Managing Director of Smedvig Marine Contracting	Other
Digital Marketing Production Executive	Marketing
EVP, Sales & Marketing & Co-Founder	Sales
Global Customer Growth and Innovation Evangelist	Technical
Founder, General Manager and Legal	Business
Editorial Advisory Boards	Other
Director, Marketing & Education Programs	Marketing
Project Co-Ordinator	Business
Co-founder, VP, Bus Dev, Marketing, Strategy	Business
CEO of MENA Division	Business
Chair of Simplifying the Business (StB)	Business
Vice President & Creative Director	Business
Digital, Innovation, Growth	Technical
Stitching Crew	Other
Head of SEO www.hyperassur.com	Business
Press Representative	Other
Director of Client Education	Business
VP Global Ad Sales & Brand Partnerships	Sales
Senior Manager, South Europe Data Networks Engineering	Technical
President, Cigna Health Services | Executive Chairman, Cigna Health Services companies	Business
Associate, Investment Strategy Group	Business
Centennial Professor, Department of Political Science	Other
Vice President of Original Content	Business
Chief Operating Officer and General Manager	Marketing
Director / Co-founder	Business
Manager, User Stories	Other
President of Construction Equipment	Business
Co-founder, Marketing & Product Strategy Director	Business
President & CEO, Founder & Director	Business
Vice president, Publisher	Business
Pricing Strategist & Metalsmithing Apprentice	Marketing
Responsable marketing Studios	Marketing
Vice President Operations, North America	Business
COO (owner)	Business
Member of the Board of Trustees, New York City Chapter	Business
Executive Vice President, Global Business Development	Business
VP of North American Business Development	Business
Public Information Consultant	Other
Co-Founder, Chief of Technology	Business
CEO & CTO and Co-Founder	Business
PhD Researcher (VSL)	Other
VP of Quality & Innovation	Technical
SVP Creative and Content Development	Business
Lead Consultant Asia Pacific	Other
CFO / EVP	Business
President Global Sales and Customer Experience (energy group)	Sales
Iteration Manager	Other
Management Consultant - Interim Chief Financial Officer	Business
Visualization, Public Relations	Business
Chief of Marketing and Customer Success	Marketing
Founder/ Chief Creative Officer	Business
Director of BIC Granada	Business
Data Scientist and Firmware Engineer	Technical
Chief Creative Officer. NY	Business
Innovation & Entrepreneurship Adviser	Technical
VP of Customer Success & On-boarding	Business
Regional Vice President of Business Development	Business
Senior Instructional Technologist	Other
NLP Engineer	Technical
Chemistry/Materials Co-op	Other
Head of Internal Audit Corporate	Business
VP â Product Engineering	Technical
Search Account Executive	Other
Executive Vice-President, Director	Business
Director of Corporate Communications	Business
Head - Microsoft Student Lab	Business
Executive Director, Chemistry	Business
IT Labs Manager	Other
Full-time member of the staff and works council	Other
SAP Technical Delivery Manager	Technical
Bachelor of Commerce (BCom), Marketing, Management	Marketing
